20 20
10 0
4  19
####################
####################
#####++++++++++++++#
#####+##############
#####+#########+++++
####++##++++++++####
#++++##########+####
#+##++++++#####+####
#+####+####+++#+####
#+###########+#+####
++++++++++++++#+####
####+##########+####
####+##########+####
#++++##########+####
#+##++++++++++++####
#+######+#########+#
#+######+#########+#
#+######++++++++++++
####################
####################
